Aiken Danny	LS
Allen Will	CB
Arrington Kyle	CB
Barrett Josh	DB
Bequette Jake	DE
Brace Ron	DE
Brady Tom	QB
Branch Deion	WR
Brown Sergio	SS
Cannon Marcus	T
Carpenter Bobby	OLB
Carter Markell	LB
Chung Patrick	FS	
Cole Marquice	DB	
Connolly Dan	G
Cunningham Jermaine	OLB	
Davis Britt	WR
Deaderick Brandon	DE
Dennard Alfonzo	CB
Dowling Ras-I	DB
Ebert Jeremy	WR
Ebner Nate	DB
Edelman Julian	WR
Fanene Jonathan	DE
Fells Daniel	TE
Fiammetta Tony	FB	
Fletcher Dane	LB
Gallery Robert	G
Gonzalez Anthony	WR
Gostkowski Stephen	K
Gregory Steve	SS
Gronkowski Rob	TE	
Harrison Marcus	DT	
Hartline Mike	QB
Hernandez Aaron	TE
Hightower Donta	LB
Hix Kyle	OL
Hoyer Brian	QB
Jones Chandler	DE
Kettani Eric	RB
Koepplin Chris	K
Kopa Mat	T
Koppen Dan	C
Koutouvides Niko	LB
Larsen Spencer	FB	
Lavarias Aaron	DL
Light Matt	T
Lloyd Brandon	WR	
Love Kyle	DT
Mallett Ryan	QB
Mankins Logan	G
Mayo Jerod	ILB	
McCourty Devin	CB
McDonald Nick	G
Mesko Zoltan	P	
Moore Sterling	CB
Ninkovich Rob	OLB	
Ochocinco Chad	WR
Pryor Myron	DT	
Ridley Stevan	RB	
Rivera Mike	LB	
Scott Trevor	DE	
Silvestro Alex	DE
Slater Matthew	WR	
Solder Nate	T
Spikes Brandon	ILB	
Stallworth Donte'	WR	
Tarpinian Jeff	LB
Thomas Donald	OG	
Underwood Tiquan	WR	
Ventrone Ross	DB	
Vereen Shane	RB
Vollmer Sebastian	T	
Waters Brian	G
Welker Wes	WR
Wendell Ryan	C
White Tracy	LB	
Wilfork Vince	NT
Williams Malcolm	DB
Wilson Tavon	FS
Woodhead Danny	RB